XXXXXXXXXXXXXXXXXXXXXXXXXXXXXXXXXXXXXXXXX
X   X             P         X           X
X   X   XXXXXXXXXXXXXXXXX   X   XXXXX   X
X   X           X           X   X       X
X   XXXXXXXXX   X   XXXXXXXXX   X   XXXXX
X               X           X   X       X
XXXXXXXXX   XXXXXXXXXXXXX   XXXXXXXXX   X
X   X       X                           X
X   X   XXXXXXXXXXXXXXXXXXXXXXXXX   X   X
X       X               X       X   X   X
X   XXXXX   XXXXXXXXX   X   XXXXX   X   X
X       X   X       X   X           X   X
X   X   X   X   X   X   XXXXXXXXX   X   X
X   X   X   X   X   X   X           X   X
XXXXX   X   XXXXX   X   X   XXXXXXXXX   X
X       X               X   X           X
X   XXXXXXXXX   XXXXX   X   X   XXXXX   X
X           X       X   X       X   X   X
X   XXXXXXXXX   X   X   XXXXX   X   X   X
X               X   X E X       X       X
XXXXXXXXXXXXXXXXXXXXXXXXXXXXXXXXXXXXXXXXX